    111111111111111111111  
 111100000000000000000001  
1000010001111000111110011  
1000010001  10001   1001   
1001000001  1000111110011  
10000N0001  1000000000011  
1100111111111111111111111  
110011
110011
110011
110011
111111
