    111111111111111111111
 111100000000000000000001
1000010001111000111111111
1000010001  10001        
1000000001  1000111111111
100W000001  100000000001
110011111111111111111111
110011
110011
110011
110011
111111
