    111111111111111111111
 111100000000000000000001
1000010001111000111111111
1000010001  10001        
100E000001  1000111111111
1000000001  1000000000001
1111111111111111111111111
                        