1111111111
1000110001
1000110001
1001111001
1000000001
1000W00001
1000000001
1110000111
1000000001
1111111111
