R 1080 720

NO ./textures/north.xpm
SO ./textures/south.xpm
WE ./textures/west.xpm
EA ./textures/east.xpm

S ./textures/sprite.xpm

F 153,153,0
C 112,112,112

        1111111111111111111111111
        1000000000000000000000001
        1000000000000000000000001
        1000000000000200000000001
111111111000000000000000000000001
10000000000000N000000000000001111
10000000000000000000111111111
1000200002000000000001
10000000000020000000111111111
10000000200000000000000000001
10000000000000000001010000001
11000001110101011111011110101
11111111 1110111 111111110001
11111111 1111111 111111111111
