1111111111
1000110001
1000110001
1001111N01
1000000001
1010000101
1000000001
1110000111
1000000001
1111111111
