R 1080 720

NO ./textures/north.xpm
SO ./textures/south.xpm
EA ./textures/east.xpm
WE ./textures/west.xpm

S ./textures/sprite.xpm

C 112,112,112
F 153,0,0
            1
    11111111211111111
 11100011000000000001
10001100000000000111
100111100002020001
100000000000000001
1010000100000W0001
100000000000000001
111000011000000001
100011000000000001
100111100000000001
100000000000000001
101000010000000001
100000000000000001
111111111111111111
